 androstadienu pochodne -->  17 - hydroxywortmannin ( 17 - hydroxywortmannin)
 non - neoplastic gonadal disorder -->  ageneze gonad ( gonadalni ageneze)
 niedosłuch -->  sindrome de kabuki ( kabuki - syndrom)
 sjogren - larsson syndrome -->  kabuki syndrome ( kabuki - syndrom)
 estructura morfologicamente anormal -->  kabuki syndrome ( kabuki - syndrom)
 kmt2d , thr5464met -->  sindrome di kabuki ( kabuki - syndrom)
 osteoectasia with hyperphosphatasia ( disorder ) -->  kabuki make - up syndrome ( kabuki - syndrom)
 chromosome 1p36 deletion syndrome ( disorder ) -->  kabuki - syndroom ( kabuki - syndrom)
 indium chloride ( incl3 ) -->  indium - 113m chloride ( indium ( 113 - in ) chloride ( substance ))
 indium - radioisotopy -->  producto que contiene cloruro de indio ( 113 - in ) ( indium ( 113 - in ) chloride ( substance ))
 indium113 chloride ( substance ) -->  indium < sup > 113 < / sup > chloride ( product ) ( indium ( 113 - in ) chloride ( substance ))
 indio113m ( sustancia ) -->  indium ( 113 - in ) chloride ( indium ( 113 - in ) chloride ( substance ))
 borderline malignancy tumor -->  sertolizell - tumor ( sertolicelletumor)
 ec -->  tumor de celulas de sertoli , sin subtipo cie - o ( anomalia morfologica ) ( sertolicelletumor)
 krev -->  sertoli cell tumor nos ( sertolicelletumor)
 history -->  sertoli cell tumor ( sertolicelletumor)
 sertoli cell tumor , benign -->  sertoli cell adenomas ( sertolicelletumor)
 sertoli cell tumor , benign -->  [ m ] tubular androblastoma nos ( sertolicelletumor)
 psychol -->  testicular adenoma ( sertolicelletumor)
 tumors , sertoli - leydig cell -->  sertoli cell tumour - retired - ( sertolicelletumor)
 parasitology -->  sertoli cell tumor , nos ( sertolicelletumor)
 aminopirydyny pochodne -->  methylaminy ( metilaminas)
 procambarus -->  procambarus clarkii ( procambarus clarkii ( girard , 1852 ))
 gastropleuralis fistula -->  fistola gengivale ( fistula dentalis)
 diagnosis aspect -->  fistula dental ( fistula dentalis)
 embryology -->  dental fistula ( fistula dentalis)
 complication aspects -->  fistula , alveolar process ( fistula dentalis)
 fistola gastrosplenica -->  fistula dentaria ( fistula dentalis)
 ekonomika -->  fistula dent ( fistula dentalis)
 absceso periapical con tracto sinusal -->  [UNK] [UNK] [UNK] ( fistula dentalis)
 паротит -->  fistola dentaria ( fistula dentalis)
 dental materials , impression , rubber - based , silicone -->  permlastic ( dental materials , impression , rubber - based , polysulfide)
 molecular target inhibitors -->  4 - ( 3 ' - chloro - 4 ' - fluoroanilino ) - 7 - methoxy - 6 - ( 3 - morpholinopropoxy ) quin ( 4 - ( 3 ' - chloro - 4 ' - fluoroanilino ) - 7 - methoxy - 6 - ( 3 - morpholinopropoxy ) quin)
 zasobovani a distribuce -->  gefitinib product ( 4 - ( 3 ' - chloro - 4 ' - fluoroanilino ) - 7 - methoxy - 6 - ( 3 - morpholinopropoxy ) quin)
 product containing larotrectinib ( medicinal product ) -->  n - ( 3 - chloro - 4 - fluorophenyl ) - 7 - methoxy - 6 - [ 3 - ( 4 - morpholin ) prop ( 4 - ( 3 ' - chloro - 4 ' - fluoroanilino ) - 7 - methoxy - 6 - ( 3 - morpholinopropoxy ) quin)
 chemie -->  гефитиниб ( 4 - ( 3 ' - chloro - 4 ' - fluoroanilino ) - 7 - methoxy - 6 - ( 3 - morpholinopropoxy ) quin)
 saprolegnia ( organismo ) -->  saprolegnia parasitica ( organismo ) ( saprolegnia parasitica)
 duodenalis fekelyek es perforatio -->  erosiv duodenitis ( erosive duodenitis)
 duodenalni vred s obstrukci -->  [UNK] дуоденит ( erosive duodenitis)
 入 [UNK] 前 [UNK] [UNK] -->  sleepwalk ( disturbo da sonnambulismo)
 行 [UNK] [UNK] [UNK] - [UNK] [UNK] [UNK] [UNK] -->  sleep walk ( disturbo da sonnambulismo)
 snoring was observed -->  nachtwandeln ( disturbo da sonnambulismo)
 rem behavior disorders -->  somnanbulism ( disturbo da sonnambulismo)
 [UNK] [UNK] [UNK] [UNK] [UNK] -->  somnambulismus ( disturbo da sonnambulismo)
 disorders , sleep wake -->  disorder ; sleepwalking ( disturbo da sonnambulismo)
 porucha chovani behem rem spanku -->  trastorno de caminar dormido ( disturbo da sonnambulismo)
 [ d ] insomnio , sai ( situacion ) -->  nonorganic sleepwalking disorder ( disturbo da sonnambulismo)
 spankova obrna -->  camminare nel sonno ( disturbo da sonnambulismo)
 sna - bodrstvovaniia rasstroistva -->  lunatisme ( disturbo da sonnambulismo)
 nespavost -->  [UNK] 中 [UNK] 行 ( disturbo da sonnambulismo)
 snoring -->  ambulacao durante o sono ( disturbo da sonnambulismo)
 genus ficedula -->  ficedula hypoleuca ( organismo ) ( ficedula hypoleuca)
 metilpropilketony -->  alcohol diacetona ( sustancia ) ( alcohol diacetona)
 ile -->  amino - acides essentiels ( aminosyror , essentiella)
 benzenepropanoic acid , alpha - oxo - , mixt . with ( + - ) - 2 - hydroxy - 4 - ( methylthio ) -->  aminosauren , essentielle ( aminosyror , essentiella)
 therapeutic use -->  amino acids , essential ( aminosyror , essentiella)
 phenylalaninum -->  aminoacides indispensables ( aminosyror , essentiella)
 l - methionine ( substance ) -->  essential amino acids ( aminosyror , essentiella)
 toxicity aspects -->  acides amines indispensables ( aminosyror , essentiella)
 hallazgo relativo a la arteria retiniana -->  niedroznosc tetnicy siatkowki ( [UNK] 膜 分 [UNK] [UNK] [UNK] [UNK] [UNK] 症)
 cerebrospinal fluid -->  oclusion de arteria de la retina ( trastorno ) ( [UNK] 膜 分 [UNK] [UNK] [UNK] [UNK] [UNK] 症)
 retinal vessel exam -->  [UNK] 膜 中 心 [UNK] [UNK] [UNK] [UNK] 症 ( [UNK] 膜 分 [UNK] [UNK] [UNK] [UNK] [UNK] 症)
 aneurisma da retina -->  oclusao da arteria retiniana ( [UNK] 膜 分 [UNK] [UNK] [UNK] [UNK] [UNK] 症)
 vasospasmo da macula lutea -->  [UNK] 膜 [UNK] [UNK] [UNK] [UNK] 症 ( [UNK] 膜 分 [UNK] [UNK] [UNK] [UNK] [UNK] 症)
 lesie ; vasculair , retina -->  occlusion retinal artery ( [UNK] 膜 分 [UNK] [UNK] [UNK] [UNK] [UNK] 症)
 nursing care -->  afsluiting ; retina , arterie ( [UNK] 膜 分 [UNK] [UNK] [UNK] [UNK] [UNK] 症)
 disease of non - coronary systemic artery ( disorder ) -->  arterie ; afsluiting , arterie retina ( [UNK] 膜 分 [UNK] [UNK] [UNK] [UNK] [UNK] 症)
 lipidemia retiniana -->  oclusion de la arteria retiniana ( [UNK] 膜 分 [UNK] [UNK] [UNK] [UNK] [UNK] 症)
 retinal vascular thrombosis nos -->  artery occlusion retinal ( [UNK] 膜 分 [UNK] [UNK] [UNK] [UNK] [UNK] 症)
 [UNK] расширение [UNK] [UNK] -->  nathinneartarocklusion ( [UNK] 膜 分 [UNK] [UNK] [UNK] [UNK] [UNK] 症)
 sodium monofluorophosphate 0 . 76 g in 100 g dental paste , dentifrice [ simple truth kids flouride ] -->  sodium phosphate , tribasic , dodecahydrate ( sodium phosphate , tribasic , dodecahydrate)
 ataxie cerebelleuse precoce -->  dyssynergia cerebellaris myoclonica ; hunt ( dyssynergia cerebellaris myoclonica of hunt)
 sphaeroma -->  sphaeroma serratum ( sphaeroma serratum)
 f [ preparations ] -->  factor ix complex preparation ( coagulation factor ix complex human)
 4f - pcc -->  factor ix complex human ( coagulation factor ix complex human)
 haemostatic drug -->  factor ix complex agent ( coagulation factor ix complex human)
 hem -->  factor ix complex agent ( substance ) ( coagulation factor ix complex human)
 factor ix complex injectable product -->  4f - pcc ( coagulation factor ix complex human)
 magnesium borate ( substance ) -->  borate ( substance ) ( borati)
 toxicita -->  borato ( producto ) ( borati)
 fosfater -->  [UNK] 酸 [UNK] ( borati)
 serine - borate complex -->  borato ( sustancia ) ( borati)
 aniones -->  borato , producto ( borati)
 chem -->  taftsin ( tuftsine)
 abciximab ( medication ) -->  туфтеин ( tuftsine)
 cloruro polivinilico ( sustancia ) -->  vinylite ( vinylite)
 5 - hydroxy tryptophan ( substance ) -->  5 - hydroxy - n - acetyltryptophan ( 5 - hydroxy - n - acetyltryptophan)
 peptidos ciclicos -->  ( h - tyrosyl - lysyl - glycyl - phenylalanyl - glutamamide ) 2 ( cyclic dimer tlgpg)
 constan [UNK] -->  esparon ( esparon)
 genetika -->  thermus aquaticus subsp . thermophilus ( thermus thermophilus ( organism ))
 izolace a purifikace -->  thermus aquaticus ( subsp . thermophilus ) ( thermus thermophilus ( organism ))
 onchocerciasis , okular -->  cegueira dos rios ( onchocerkoza oka)
 [UNK] [UNK] 膜 -->  [UNK] [UNK] ( onchocerkoza oka)
 chorioretinitis onchocerca -->  folyami vaksag ( onchocerkoza oka)
 taxonomy -->  ceguera de rio ( onchocerkoza oka)
 enfermedad de la ceguera -->  flußblindheit ( onchocerkoza oka)
 paludismo -->  слепота [UNK] ( onchocerkoza oka)
 complications -->  rivierblindheid ( onchocerkoza oka)
 感 染 症 - [UNK] - [UNK] 生 [UNK] 性 -->  blindness , river ( onchocerkoza oka)
 12 - hydroxyrotenone -->  rotenolone , ( 2r - ( 2alpha , 6abeta , 12aalpha ) ) - isomer ( rotenolone , ( 2r - ( 2alpha , 6abeta , 12aalpha ) ) - isomer)
 leghe -->  resines vegetales ( [UNK] 物 [UNK] [UNK] [UNK])
 myrrh -->  hartser ( [UNK] 物 [UNK] [UNK] [UNK])
 producto con resina de podofilina -->  resin ( [UNK] 物 [UNK] [UNK] [UNK])
 corneal neovascularization -->  hornhinneendotelcelletap ( corneal endothelial cell loss)
 rehabilitace -->  endotelcellsforlust , korneal ( corneal endothelial cell loss)
 увеит - глаукома - гифема -->  内 皮 [UNK] 胞 [UNK] 少 - [UNK] 膜 ( corneal endothelial cell loss)
 [UNK] -->  ubytek endotelialnich bunek rohovky ( corneal endothelial cell loss)
 protesesvikt -->  rogovichnykh endotelial ' nykh kletok snizhenie ( corneal endothelial cell loss)
 [UNK] -->  utrata komorek srodbłonka rogowki ( corneal endothelial cell loss)
 usni komplikace vykonu -->  [UNK] [UNK] клеток [UNK] ( corneal endothelial cell loss)
 dash eating plan -->  failure , circulatory ( shock circulatorio)
 postpartum shock -->  gipovolemicheskii shok ( shock circulatorio)
 albumin aggregated -->  [UNK] [UNK] 性 [UNK] ( shock circulatorio)
 metaplasia , nos -->  akutes kreislaufversagen ( shock circulatorio)
 dys - symbiosis -->  shock nos ( shock circulatorio)
 reduced systolic function -->  血 管 [UNK] [UNK] ( shock circulatorio)
 immunology aspects -->  perifere vaatcollaps ( shock circulatorio)
 treatment -->  shock ; syndroom ( shock circulatorio)
 disease management -->  acute circulatory failure ( shock circulatorio)
 shock prevention -->  obehovy kolaps ( shock circulatorio)
 ateromatosis -->  obehovy sok ( shock circulatorio)
 ipoperfusione -->  niet - gespecificeerde shock ( shock circulatorio)
 meningococc adrenal synd -->  心 血 管 [UNK] [UNK] ( shock circulatorio)
 severe sepsis with septic shock ( diagnosis ) -->  sokki ( shock circulatorio)
 enfermedad de raynaud -->  circulatoire shock ( shock circulatorio)
 lipoproteiner , ldl -->  collaps ; cardiovasculair ( shock circulatorio)
 chemicky indukovane -->  shok ( shock circulatorio)
 degeneration , nerve -->  shock , nos ( shock circulatorio)
 [UNK] [UNK] -->  insufficienza circolatoria periferica ( shock circulatorio)
 shock following induced termination of pregnancy -->  [UNK] ( shock circulatorio)
 mi - myocardial infarction -->  [UNK] [UNK] ( shock circulatorio)
 complicazioni post - operatorie nas -->  insuficiencia vascular aguda ( shock circulatorio)
 cl -->  syndrome ; shock ( shock circulatorio)
 hemorrhagic shock and encephalopathy syndrome -->  defaillance circulatoire ( shock circulatorio)
 torsade de pointes , quadros clinicos associados ao choque ( smq ) -->  [UNK] [UNK] [UNK] ( shock circulatorio)
 sokk vajudas es szules idejen vagy azt kovetoen , szules elotti allapot emlites -->  versagen des peripheren kreislaufs ( shock circulatorio)
 moczenie sie mimowolne -->  kreislaufversagen ( shock circulatorio)
 elevated amylase -->  collapse peripheral circulatory ( shock circulatorio)
 n - ( 2 - chloroethyl ) - n - ( 1 - methyl - 2 - phenoxyethyl ) - benzenemethanamine -->  vascularis collapsus ( shock circulatorio)
 [UNK] [UNK] -->  shock , physiological ( shock circulatorio)
 systemova anafylakticka reakce -->  collapsus cardio - vasculaire ( shock circulatorio)
 [UNK] -->  failure circulatory ( shock circulatorio)
 cukor , vizeletben -->  collapsus circulatoire ( shock circulatorio)
 parazitologie -->  kollaps , kardiovaskulaer ( shock circulatorio)
 syndrome ( tss ) , toxic shock -->  falen circulatoir ( shock circulatorio)
 zanik skory pstry naczyniasty wrodzony -->  acroqueratosis verruciforme de hopf ( trastorno ) ( [UNK] [UNK])
 hyperkeratosis lenticularis perstans -->  acroqueratose verruciforme ( [UNK] [UNK])
 kisti deformatsii vrozhdennye -->  malattia di hopf ( [UNK] [UNK])
 hlp -->  [UNK] [UNK] [UNK] ( [UNK] [UNK])
 congenitale poikilodermie -->  [UNK] ( [UNK] [UNK])
 failure ; renal -->  hypertonicity of bladder ( hypertoniciteit van de blaas)
 acontractile detrusor ( disorder ) -->  uberaktive blase ( hypertoniciteit van de blaas)
 metab -->  ipertonicita vescicale ( hypertoniciteit van de blaas)
 pp -->  hypertonicity of bladder ( diagnosis ) ( hypertoniciteit van de blaas)
 biological structure -->  [UNK] тонус [UNK] [UNK] ( hypertoniciteit van de blaas)
 ipercalcinuria -->  [UNK] 活 [UNK] [UNK] [UNK] 症 [UNK] 群 ( hypertoniciteit van de blaas)
 detrusor muscle hyperactivity -->  overactieve blaas ( hypertoniciteit van de blaas)
 lecba -->  hypertonic bladder ( hypertoniciteit van de blaas)
 immunol -->  [UNK] [UNK] ( hypertoniciteit van de blaas)
 renaal ; cyste -->  hypertonicite de la vessie ( hypertoniciteit van de blaas)
 hyperactivity of bladder ( diagnosis ) -->  overactief ; blaas ( hypertoniciteit van de blaas)
 other and unspecified diseases of bladder and urethra -->  bladder hypertonicity ( hypertoniciteit van de blaas)
 urinary bladder structure ( body structure ) -->  overactive bladder ( hypertoniciteit van de blaas)
 urinary tract infectious disease -->  hyperaktivni mocovy mechyr ( hypertoniciteit van de blaas)
 dermoid choristoma of eye proper -->  dermoids of cornea ( dermoids of cornea)
 eye lump -->  dermoids of cornea ( dermoids of cornea)
 ectodermal dysplasia trichoodontoonychial type ( diagnosis ) -->  not translated [ hypotrichosis ] ( hypotrikose)
 hypotrichosis , total , mari type -->  [UNK] [UNK] 症 ( hypotrikose)
 leukomelanoderma , infantilism , mental retardation , hypodontia , hypotrichosis -->  [UNK] [UNK] 不 全 症 ( hypotrikose)
 ( congenital monilethrix ) or ( beaded hair ) ( disorder ) -->  [UNK] [UNK] [UNK] 少 ( hypotrikose)
 [UNK] -->  gipotrikhiia ( hypotrikose)
 microcystis -->  microcystis aeruginosa ( organismo ) ( microcystis aeruginosa)
 capim - buffel -->  pennisetum glaucum ( pennisetum typhoideum)
 fountain grasses -->  pennisetum americanum ( organismo ) ( pennisetum typhoideum)
 viral labyrinthitis , nos -->  fievre hemorragique ( fiebre hemorragica)
 immunization , childhood -->  unspecified viral hemorrhagic fever ( fiebre hemorragica)
 polio and post - polio syndrome -->  virus ; hemorragische koorts ( fiebre hemorragica)
 hemangioma rupturaja -->  [UNK] [UNK] [UNK] ( fiebre hemorragica)
 reovirusinfectie -->  vhf - viral haemorrhagic fever ( fiebre hemorragica)
 respiratoriska syncytialvirusinfektioner -->  hemorrhagic fever , viral ( fiebre hemorragica)
 subcapsular splenic hematoma -->  fiebre viral hemorragica , no especificada ( trastorno ) ( fiebre hemorragica)
 isorokko -->  fever ; hemorrhagic , viral ( fiebre hemorragica)
 haematom nach eingriff -->  febre hemorragica ( fiebre hemorragica)
 [UNK] -->  hamorrhagische fieber , virale ( fiebre hemorragica)
 class -->  fevers haemorrhagic viral ( fiebre hemorragica)
 rehabil -->  hemorrhagic fever ( fiebre hemorragica)
 psychology qualifier -->  unspecified viral haemorrhagic fever ( fiebre hemorragica)
 traumatic ; epileptic -->  hersenzwelling ( intracranial edema)
 [UNK] -->  intracranial swelling ( intracranial edema)
 hipertensao intracraniana -->  inchaco do cerebro ( intracranial edema)
 1 - ethyl - 4 - ( 2 - morpholinoethyl ) - 3 , 3 - diphenyl - 2 - pyrrolidinone -->  intracraniaal oedeem ( intracranial edema)
 fosfato sodico de dexametasona ( producto ) -->  edema brain ( intracranial edema)
 mutismo aquinetico -->  edema citotoxico do encefalo ( intracranial edema)
 enzymology -->  hinchazon del cerebro ( intracranial edema)
 doxapram hydrochloride -->  edema intracraniale ( intracranial edema)
 大 [UNK] 皮 [UNK] [UNK] 死 症 -->  hjerneødem ( intracranial edema)
 injuries to the head ( s00 - s09 ) -->  edema cerebrale ( intracranial edema)
 [UNK] -->  hersenzwelling ( intracranial edema)
 extraaxiale blutung -->  brain swellings ( intracranial edema)
 ethnology -->  edema cerebral citotoxico ( intracranial edema)
 genero bacillus -->  bacillus pasteurii ( bacillus pasteurii ( miquel 1889 ) chester 1898 ( approved lists 1980 ))
 acetato de desoxicorticosterona ( sustancia ) -->  desoxykorton - lek ( desoxykorton - lek)
 cute pruriginosa -->  [UNK] ( vulvalni pruritus)
 [UNK] система -->  vulvar pruritus ( vulvalni pruritus)
 vulvitis ( physical finding ) -->  swiad sromu ( vulvalni pruritus)
 pruritus on foot -->  klada i vulva ( vulvalni pruritus)
 veterinary aspects -->  [UNK] [UNK] [UNK] [UNK] 症 ( vulvalni pruritus)
 skin ; appendage -->  外 [UNK] [UNK] 症 ( vulvalni pruritus)
 pathol -->  itch ; vulva ( vulvalni pruritus)
 [UNK] [UNK] -->  外 [UNK] 部 [UNK] [UNK] 症 ( vulvalni pruritus)
 genetics -->  itchy vulva ( vulvalni pruritus)
 pruritis on abdomen -->  pruritis of vulva ( vulvalni pruritus)
 liquen escleroso y atrofico de la vulva ( trastorno ) -->  pruritus van de vulva ( vulvalni pruritus)
 identificacao de orientia tsutsugamushi : ident : pt : xxx : nom : amplificacao / sequenciament -->  orientia tsutsugamushi ( orientia tsutsugamushi ( organism ))
 growth and development -->  rikketsii tsutsugamushi ( orientia tsutsugamushi ( organism ))
 anticuerpo contra orientia tsutsugamushi litchfield : concentracion arbitraria : punto en el tiempo : su -->  tsutsugamushi likhoradka , vozbuditel ' ( orientia tsutsugamushi ( organism ))
 anticuerpo contra orientia tsutsugamushi litchfield : concentracion arbitraria : punto en el tiempo : su -->  [UNK] ( orientia tsutsugamushi ( organism ))
 [UNK] -->  subacute hemorrhagic leukoencephalitis ( subacute hemorrhagic leukoencephalitides)
 leucoencefalite subacuta emorragica -->  subakutt hemoragisk leukoencefalitt ( subacute hemorrhagic leukoencephalitides)
 im -->  steatocystom mnohocetny ( steatocystom mnohocetny)
 skin hypoplasia -->  steatocystoma , multiplex ( steatocystom mnohocetny)
 peripheral schwannoma -->  [UNK] [UNK] ( steatocystom mnohocetny)
 cutaneous myxoma -->  multiple sebaceous cyst ( steatocystom mnohocetny)
 generalized lipodystrophy -->  naevus kystiques pilosebaces dissemines ( steatocystom mnohocetny)
 komplikace -->  steatocistoma multiplo ( steatocystom mnohocetny)
 genetics -->  mnogie torbiele łojowe ( steatocystom mnohocetny)
 visszatero hypernephroma -->  oncocytoma kidney ( [UNK] [UNK] [UNK] [UNK])
 epithelium -->  kidney oncocytoma ( [UNK] [UNK] [UNK] [UNK])
 [UNK] [UNK] [UNK] -->  oncocytoma , renal ( [UNK] [UNK] [UNK] [UNK])
 wilm ' s tumor -->  oncocitoma renal ( [UNK] [UNK] [UNK] [UNK])
 quiluria ( hallazgo ) -->  微 量 [UNK] [UNK] 症 ( [ d ] albuminuria ( context - dependent category ))
 physiopathology -->  [ d ] albuminuria ( [ d ] albuminuria ( context - dependent category ))
 acucar urinario presente -->  proteinuria albuminuria ( [ d ] albuminuria ( context - dependent category ))
 mortalita -->  [UNK] ( [ d ] albuminuria ( context - dependent category ))
 [UNK] [UNK] -->  [ d ] albuminuria ( categoria dependiente del contexto ) ( [ d ] albuminuria ( context - dependent category ))
 deafmutism - retinal degeneration syndrome ( disorder ) -->  mutisme ; doof ( deaf mutism ( diagnosis ))
 [UNK] [UNK] -->  surdimutite ( deaf mutism ( diagnosis ))
 [UNK] -->  deafmutism ( deaf mutism ( diagnosis ))
 [UNK] [UNK] [UNK] [UNK] 症 [UNK] 群 -->  deaf mutism ( deaf mutism ( diagnosis ))
 fda unii code terminology -->  bedaquiline fumarate ( bedaquiline fumarate)
 ap - 7 compound -->  2 - amino - 7 - phosphonoheptanoic acid , ( s ) - isomer ( 2 - amino - 7 - phosphonoheptanoic acid , ( s ) - isomer)
 nemoci z valecneho stresu -->  stress disorder , combat ( stress disorders , combat)
 proprotein convertase 1 3 deficiency -->  postprandial hypoglycaemia ( hypoglycemie post - prandiale)
 stofwisselingsstoornis , voedings - en -->  hypoglykemicka reakce ( hypoglycemie post - prandiale)
 post gastrointestinal tract surgery hypoglycemia ( disorder ) -->  reaction hypoglycemic ( hypoglycemie post - prandiale)
 nonketotic hypoglycemia -->  reaction hypoglycaemic ( hypoglycemie post - prandiale)
 [UNK] [UNK] [UNK] в [UNK] -->  reactive hypoglycaemia nos ( hypoglycemie post - prandiale)
 probavni sustav -->  reactive hypoglycemia ( hypoglycemie post - prandiale)
 drug - induced hypoglycemia without coma ( diagnosis ) -->  post prandial hypoglycemia ( hypoglycemie post - prandiale)
 [UNK] [UNK] -->  hypoglycemic reactions ( hypoglycemie post - prandiale)
 [UNK] -->  reactive hypoglycemia nos ( disorder ) ( hypoglycemie post - prandiale)
 [UNK] [UNK] [UNK] [UNK] [UNK] -->  hypoglycemia ; reactive ( hypoglycemie post - prandiale)
 [UNK] [UNK] [UNK] -->  hypoglycaemias reakcio ( hypoglycemie post - prandiale)
 hypoketotic hypoglycemia -->  hipoglucemia postprandial ( hypoglycemie post - prandiale)
 otitis externa en herpes zoster -->  ramsay hunt syndrome type 2 ( hunt ' s syndrome)
 unclassified thermus -->  thermus sp . ( thermus sp .)
 temblor intencional ( hallazgo ) -->  opcax ( opca , x - linked)
 parasitology -->  pseudotumor inflamatorio pulmonar ( inflammatory pseudotumors , pulmonary)
 pathology -->  inflammatory lung pseudotumor ( inflammatory pseudotumors , pulmonary)
 肺 [UNK] 核 -->  inflammatory pulmonary pseudotumor ( inflammatory pseudotumors , pulmonary)
 tumor no clasificado , benigno -->  pseudotumor inflamm pulm ( inflammatory pseudotumors , pulmonary)
 pulmon en shock -->  гранулема [UNK] [UNK] ( inflammatory pseudotumors , pulmonary)
 prev -->  zanetlivy plicni pseudotumor ( inflammatory pseudotumors , pulmonary)
 pseudotumor ( morphologic abnormality ) -->  pseudotumor inflamatorio pulmonar ( inflammatory pseudotumors , pulmonary)
 pulmonary coin lesions -->  pseudotumor , entzundlicher pulmonaler ( inflammatory pseudotumors , pulmonary)
 pseudotumor , nos -->  inflamm pseudotumor lung ( inflammatory pseudotumors , pulmonary)
 immunology -->  psevdonovoobrazovanie vospalitel ' noe legochnoe ( inflammatory pseudotumors , pulmonary)
 maladies pulmonaires parenchymateuses diffuses -->  plice - pseudotumor zanetlivy ( inflammatory pseudotumors , pulmonary)
 lesion de pulmon ( hallazgo ) -->  [UNK] [UNK] [UNK] - [UNK] 症 性 - 肺 ( inflammatory pseudotumors , pulmonary)
 mi -->  pulmonary granuloma , plasma cell ( inflammatory pseudotumors , pulmonary)
 pleurodele -->  pleurodeles waltl ( pleurodeles waltl)
 大 [UNK] [UNK] [UNK] -->  sporadic cerebral amyloid angiopathy ( sporadic cerebral amyloid angiopathy)
 [UNK] [UNK] [UNK] [UNK] [UNK] [UNK] -->  sporadisk cerebral amyloid angiopati ( sporadic cerebral amyloid angiopathy)
 metacrilatos -->  hydroxyethylhydroxymethylmethacrylate ( hema - mema)
 clorhidrato de topotecan ( sustancia ) -->  cancer du poumon non a petites cellules ( nonsmall cell lung cancer)
 carcinoma pulmonar de tipo celular ne recidivante -->  nonsmall cell lung cancer ( nonsmall cell lung cancer)
 epitelijsunas -->  niet - kleincellige longkanker nao ( nonsmall cell lung cancer)
 malignant lung neoplasm ( non - small cell ) stage iiib -->  肺 非 小 [UNK] 胞 [UNK] ( nonsmall cell lung cancer)
 immunoglobulin g1 , anti - ( human cd antigen cd274 ) ( human monoclonal mdpl3280a heavy chain ) , disulfide with human monoclonal mdpl3 -->  carcinoma pulmonar no microcitico ( nonsmall cell lung cancer)
